WWWWWWWWWWWWWWWWWWWW
W                  W
W         WWWWWW   W
W   WWWW       W   W
W   W        WWWW  W
W WWW  WWWW    E   W
W   W     W W      W
W   W     W   WWW WW
W   WWW WWW   W W  W
W     W   W   W W  W
WWW   W   WWWWW W  W
W W      WW    E   W
W W   WWWW   WWW   W
W S   W    F   W   W
WWWWWWWWWWWWWWWWWWWW