WWWWWWWWWWWWWWWWWWWWWWWWW
Wo                      W
W   WWWWWWWWWWWWWWW     W
W   W o W        oW     W
W   W   W    WW   W     W
W   W   Wo    W   W     W
W   W   WWWW  W   W     W
W   W     oW  W   W     W
W   WW     Wo W   WW    W
W    W     WWWW    W    W
W    WWWo        E      W
W W    WWWo        W    W
W W    WWWWWWWWWWWWW    W
W S         oW       E  W
WWWWWWWWWWWWWWWWWWWWWWWWW